NO srcs/textures/wall1.XPM
SO srcs/textures/wall2.XPM
WE srcs/textures/wall3.XPM
EA srcs/textures/wall4.XPM
F 25,184,11
C 117,225,253
1111111111111111111111111
1000000000110000010100001
1011000001110000100010001
100100000000000000000001
111111111011000000000000000000001
100000000011000000S00111111111111
11110111111111011100000010001
11110111111111011101010010001
11000000110100011100000010001
10000000000000001100000010001
10000000000000001101010010001
1100000111010101111101111000111
11110111 1110101 101111010001
11111111 1111111 111111111111
