NO srcs/textures/wall1.XPM
SO srcs/textures/wall2.XPM
WE srcs/textures/wall3.XPM
EA srcs/textures/wall4.XPM
F 25          ,              184        ,                        11
C 117,225,253
 11111111111111111111111111111111111111111111111111111111111111111111111111111111111111111111111111111111111111111111111111111111111111111111111111
1000000000000000000000000000000000000000000000000000000000000000000000000000000000000000000000000000000000000000000000000000000000000000000000000001
1000000000000000000000000000000000000000000000000000000000000000000000000000000000000000000000000000000000000000000000000000000000000000000000000001
1000000000000000000000000000000000000000000000000000000000000000000000000000000000000000000000000000000000000000000000000000000000000000000000000001
1000000000000000000000000000000000000000000000000000000000000000000000000000000000000000000000000000000000000000000000000000000000000000000000000001
1000000000000000000000000000000000000000000000000000000000000000000000000000000000000000000000000000000000000000000000000000000000000000000000000001
1000000000000000000000000000000000000000000000000000000000000000000000000000000000000000000000000000000000000000000000000000000000000000000000000001
1000000011111111111111111111000000001111111111111111111111000001100000000000000000000100000111111111111111111111100000000011111111111111111100000001
1000000010000000000000000000110000001000000000000000000000000001011000000000000000000100000000000000011000000000000000001100000000000000000000000001
1000000010000000000000000000001000001000000000000000000000000001000100000000000000000100000000000000011000000000000000010000000000000000000000000001
1000000010000000000000000000001000001000000000000000000000000001000011000000000000000100000000000000011000000000000000010000000000000000000000000001
1000000010000000000000000000001000001000000000000000000000000001000000100000000000000100000000000000011000000000000000010000000000000000000000000001
1000000010000000000000000000001000001000000000000000000000000001000000011000000000000100000000000000011000000000000000010000000000000000000000000001
1000000010000000000000000000110000001000000000000000000000000001000000000100000000000100000000000000011000000000000000001100000000000000000000000001
1000000011111111111111111111000000001111111111111111111111000001000000000011000000000100000000000000011000000000000000000011111111111111100000000001
1000000011000000000000000000000000001000000000000000000000000001000000000000100000000100000000000000011000000000000000000000000000000000011000000001
1000000010000000000000000000000000001000000000000000000000000001000000000000011000000100000000000000011000000000000000000000000000000000000100000001
1000000010000000000000000000000000001000000000000000000000000001000000000000000100000100000000000000011000000000000000000000000000000000000100000001
1000000010000000000000000000000000001000000000000000000000000001000000000000000011000100000000000000011000000000000000000000000000000000000100000001
1000000010000000000000000000000000001000000000000000000000000001000000000000000000100100000000000000011000000000000000000000000000000000000100000001
1000000010000000000000000000000000001000000000000000000000000001000000000000000000011100000000000000011000000000000000000000000000000000011000000001
1000000010000000000000000000000000001111111111111111111111000001000000000000000000001100000111111111111111111111100000011111111111111111100000000001
1000000000000000000000000000000000000000000000000000000000000000000000000000000000000000000000000000000000000000000000000000000000000000000000000001
1000000000000000000000000000000000000000000000000000000000000000000000000000000000000000000000000000000000000000000000000000000000000000000000000001
1000000000000000000000000000000000000000000000000000000000000000000000000000000000000000000000000000000000000000000000000000000000000000000000000001
1000000000000000000000000000000000000000000000000000000000000000000000000000000000000000000000000000000000000000000000000000000000000000000000000001
1000000000000000000000000000000000000000000000000000000000000000000000000000000000000000000000000000000000000000000000000000000000000000000000000001
1000000000000000000000000000000000000000000000000000000000000000000000000000000000000000000000000000000000000000000000000000000000000000000000000001
 11111111111111111111111111111111111111111111111111111111111111111111111111111111111111111111111111111111111111111111111111111111111111111111111111
